R 1080 720
NO ./textures/64_64_lake.xpm
SO ./textures/101_75_sea.xpm
WE ./textures/200_150_mountain.xpm
EA ./textures/300_255_castle.xpm

S ./textures/9_pillar.xpm
F 220,100,10
C 225,30,20

        1111111111111111111111111
        1000000000110000000000001
        1011000001110000002000001
        1001000000000000000000001
111111111011000001110000000000001
100000000011000001110111111111111
11110111111111011100000010001
11110111111111011101010010001
11000000110101011100000010201
10002000000000001100000010201
10000000000000001101010010201
11000001110101011111011112N0111
11110111 1110101 101111010001
11111111 1111111 111111111111