R 1920 1080
NO ./path_to_the_north_texture
SO ./path_to_the_south_texture
WE ./path_to_the_west_texture
EA ./path_to_the_east_texture

S ./path_to_the_sprite_texture
F 220,100,10
C 225,30,20

0011111
1110001
1000021
1110N21
  10001
  10011
  11011
  11211
  11111
  11
