R 1920 1080
NO ./textures/200_150_mountain.xpm
SO ./textures/wall_1.xpm
WE ./textures/wall_2.xpm
EA ./textures/wall_3.xpm

S ./textures/114_64_bigtree_sprite.xpm
F 220,100,10
C 225,30,20

0011111
1110001
1000021
1110N21
  10001
  10S11
  11011
  11211
  11111
  11
