R 400 200
NO ./textures/101_75_sea.xpm
SO ./textures/wall_1.xpm
WE ./textures/wall_2.xpm
EA ./textures/wall_3.xpm

S ./textures/9_pillar.xpm
F 125,20,60
C 125,20,10

0011111
1110N01
1000001
1110001
  10001
  10011
  11011
  11011
  11111
  11