R 200 100
NO ./textures/200_150_mountain.xpm
SO ./textures/64_64_lake.xpm
WE ./textures/101_75_sea.xpm
EA ./textures/300_255_castle.xpm

S ./textures/114_64_bigtree_sprite.xpm
F 125,20,60
C 0,240,240

0011111 1
1110001101111
1000W01000001
11100211111011
  102000000001111111111
  102111111000000000001
  110111111111111111011
  11011            1011
  11111
  11
