R 200 100
NO ./textures/200_150_mountain.xpm
SO ./textures/64_64_lake.xpm
EA ./textures/300_255_castle.xpm
WE ./textures/101_75_sea.xpm

S ./textures/114_64_bigtree_sprite.xpm
F 125,20,60
C 125,20,10

0011111
1110E011111
10000000001
11100111111
  100000001
  100111111
  11011
  11211
  11111
  11
