R 200 100
NO ./textures/200_150_mountain.xpm
SO ./textures/64_64_lake.xpm
WE ./textures/101_75_sea.xpm
EA ./textures/300_255_castle.xpm

S ./textures/114_64_bigtree_sprite.xpm
F 125,20,60
C 0,240,240

111111111111111111
100000000000000001
100011111111100001
100010000000100001
100010000N00100001
100010000000100001
100010000000100001
100011111111100001
100000000000000001
100000000000000001
111111111111111111
