S ./textures/114_64_bigtree_sprite.xpm
F 125,20,60
C 0,240,240
NO ./textures/200_150_mountain.xpm
SO ./textures/64_64_lake.xpm



R 500 300
WE ./textures/101_75_sea.xpm
EA ./textures/300_255_castle.xpm
0011111
1111001
1000N01
1110021
  10201
  10211
  11011
  11011
  11111
  11
